XXXXXXXXXXXXXXXXXXXXXXXXX
X.......................X
X.......................X
X.........X...X.........X
X.......................X
X.......XXXX.XXXX.......X
X.......................X
XXXXXXXXXXXXXXXXXXXXXXXXX